OOOOOOOOOOOOO
O  HH HHHH  O
O OHOHOHOHO2O
O1HH H   H HO
OHOHOHO O O O
OHHHHHHHHH HO
O OHO O O OHO
OH  HHH H HHO
OHO OHOHO OHO
OHH  H HHHHHO
O OHOHOHO O O
O3 H H HH  4O
OOOOOOOOOOOOO

