OOOOOOOOOOOOO
O1         2O
O O O O O O O
O           O
O O O O O O O
O           O
O O O O O O O
O           O
O O O O O O O
O           O
O O O O O O O
O3         4O
OOOOOOOOOOOOO
