OOOOOOOOOOOOO
O           O
O1O O O O O2O
O           O
O O O O O O O
O           O
O O O O O O O
O           O
O O O O O O O
O           O
O O O O O O O
O           O
OOOOOOOOOOOOO
