OOOOOOOOOOOOO
O1         2O
O O O O O O O
O           O
O O O O O O O
O           O
O O O O O O O
O           O
O O O O O O O
O           O
O O O O O O O
O           O
OOOOOOOOOOOOO
