OOOOOOOOOOOOO
OPXxxHHHHHXMO
OXOHOxOHOHOXO
OxHxHxHHxxxHO
OHOHOHOxOHOHO
OHHxHHHHHxxxO
OHOHOxOHOHOHO
OxxHHxxHxxxHO
OHOHOxOxOHOxO
OxHxxHxxHHxHO
OXOHOHOxOHOXO
OXXHHHHHHHXXO
OOOOOOOOOOOOO

