OOOOOOOOOOOOO
OPXxHHHHxxXMO
OXOHOxOxOxOXO
OHHHxHxHHHHHO
OHOHOHOHOxOHO
OHHxHxHHHHHHO
OHOHOHOHOHOxO
OHxxHxHHxHHxO
OxOHOHOHOxOHO
OHxHHHHHHHHHO
OXOHOHOHOHOXO
OXXHHxHHxHXXO
OOOOOOOOOOOOO

