OOOOOOOOOOOOO
O1 HH  HHH 2O
O O O OHOHO O
OHHH H HHHHHO
OHOHOHOHOHOHO
OH  H HHHHHHO
O OHOHOHOHO O
OHHHHH HHHHHO
O OHO OHOHOHO
OHH  H HHHHHO
O O OHO OHO O
O3 HHH HH  4O
OOOOOOOOOOOOO

