OOOOOOOOOOOOO
OPXHxHxHHHXMO
OXOHOHOHOHOXO
OHxHxHHxHxHHO
OxOxOHOxOHOHO
OHHxHxHHHHxxO
OxOHOHOHOHOHO
OHHxHxHHxHHHO
OHOHOHOxOxOxO
OHHxHHHHHHHxO
OXOHOHOHOHOXO
OXXxxxxHHHXXO
OOOOOOOOOOOOO

