OOOOOOOOOOOOO
OPXxxxHxHHXMO
OXOHOHOxOHOXO
OxHHHxHHxHHHO
OHOHOHOHOHOHO
OxxHHHxxHHxHO
OxOHOHOxOHOHO
OHxxxHHHxHHxO
OxOxOHOHOHOHO
OxHHHHxHxHHHO
OXOxOxOxOHOXO
OXXHxHHHHHXXO
OOOOOOOOOOOOO

