OOOOOOOOOOOOO
OPXHxHxxHxXMO
OXOxOxOHOxOXO
OxHHHHHxHxHxO
OxOxOHOxOHOHO
OHxHxHHxHHHHO
OHOHOHOHOHOHO
OxHHxxHHHHxHO
OHOxOHOxOHOHO
OxHHHxHHHHHHO
OXOHOxOHOHOXO
OXXHxHxHHHXXO
OOOOOOOOOOOOO

