OOOOOOOOOOOOO
O1xHHHHHxHx2O
OxOxOHOHOxOxO
OxxxxHHHxHxHO
OxOxOHOHOHOHO
OHHHHxHHHHxxO
OHOHOxOxOxOHO
OHHHHHHxxxxxO
OHOxOHOxOHOxO
OxHHHxHHxxxHO
OxOxOxOHOxOxO
O3xHxHxHxHx4O
OOOOOOOOOOOOO

