OOOOOOOOOOOOO
O1XHHHxxHHX2O
OXOHOHOHOHOXO
OHHHHHHHxHHHO
OxOHOxOHOHOHO
OHHxHHHHHxHHO
OxOHOxOxOHOHO
OHxHxHHHHxxHO
OHOxOHOHOHOHO
OHHxxHHHxHxHO
OXOHOxOHOHOXO
OXXxHHHHHHXXO
OOOOOOOOOOOOO

