OOOOOOOOOOOOO
O1  HHH HH 2O
O OHOHOHOHO O
OHH H HHHHH O
OHO OHOHO OHO
OH HHHHHHH  O
OHOHOHO OHO O
O HHHHHHHHHHO
OHO OHO OHO O
OHHHHH HHH  O
O OHOHOHOHO O
O3 HH HH H 4O
OOOOOOOOOOOOO

