OOOOOOOOOOOOO
O   HHHH    O
O1O OHOHO O O
O    HH     O
O OHOHOHO O O
OH HHHHHH H O
OHOHOHO OHO O
OHH   H   H O
OHO OHOHOHO O
O   HHH  HHHO
O OHOHO OHO O
O3  HH      O
OOOOOOOOOOOOO

