OOOOOOOOOOOOO
O1   HH H  2O
O O O O OHO O
OH  H   H H O
O O OHOHOHOHO
OHHHH H HH HO
OHOHOHO O O O
O HHHH  HH  O
O OHOHO OHO O
O H HHH  H HO
O O O OHOHO O
O3 HH  H H 4O
OOOOOOOOOOOOO

