OOOOOOOOOOOOO
O1 HH HHHH 2O
O OHOHOHOHO O
OHHHHH  H   O
O O OHOHO O O
OHHHHHHHHHHHO
OHOHOHOHO OHO
OH  H H HH HO
OHOHOHOHOHO O
OHHHHHHH HHHO
O OHOHO OHO O
O  HH HHHH 3O
OOOOOOOOOOOOO

