OOOOOOOOOOOOO
O1   HHHH  2O
O OHOHOHO O O
O   H HH HHHO
O O OHOHOHOHO
OH HHHH  HHHO
O O OHOHOHO O
OHH H HHH HHO
O O OHO OHOHO
OHHHHHHH HH O
O OHO OHOHO O
O3 H HH  H 4O
OOOOOOOOOOOOO

