OOOOOOOOOOOOO
O    HHHHH  O
O O O OHO O O
OH     H  HHO
OHOHOHOHOHO O
O H H HHHHHHO
OHOHO OHOHOHO
OHH HHHHHHHHO
OHOHOHOHOHO O
O  H H HH H O
O1OHOHO O O O
O   H HHHH2 O
OOOOOOOOOOOOO

