OOOOOOOOOOOOO
O    HHHHH  O
O O OHOHOHO O
O    HHHHH  O
OHO OHOHO O O
O     HH H HO
OHO OHO OHOHO
OHH H    H HO
OHO OHOHOHO O
OHH HHHHHHHHO
O OHOHOHO O O
O  H HHHHH  O
OOOOOOOOOOOOO

