OOOOOOOOOOOOO
O  HH HHHH  O
O1OHO OHOHO O
O H HH HHHH O
O OHOHOHOHOHO
O H HHHHHHHHO
O OHOHO O O O
OH HHHHHHH  O
OHOHO O OHO O
O HH HHHH H O
O OHO OHOHO O
O  H H   H  O
OOOOOOOOOOOOO

