OOOOOOOOOOOOO
O   H H HH  O
O OHOHOHO O O
OHHHHHHHH   O
OHO OHO OHO O
O HHHHH H H O
OHOHOHOHO OHO
O HHHHHHH HHO
OHOHO O O OHO
OHH  HH H H O
O O O OHO O O
O  H  HHHH  O
OOOOOOOOOOOOO

