OOOOOOOOOOOOO
O  H H HHH  O
O OHOHOHOHO O
OH H HH HHH O
OHOHOHOHOHO O
OHHHH  H H HO
O OHOHOHOHO O
OH  HHHHHH  O
O OHOHOHOHO O
OHH  H  HHH O
O O O OHOHO O
O  H HHHH   O
OOOOOOOOOOOOO

