OOOOOOOOOOOOO
O     HH H 2O
O O O OHOHO O
O       H HHO
OHO O O OHOHO
O      HHHHHO
OHO O OHOHO O
OHH    H  HHO
OHO O OHOHOHO
OHHHHHH HH HO
O O OHOHOHO O
O3 HHHHHHH 4O
OOOOOOOOOOOOO

