OOOOOOOOOOOOO
O2    HH   2O
O O O OHOHO O
OH  HHHHHHHHO
OHOHOHOHOHOHO
OHHHHHHHH HHO
O O O O OHOHO
OHHHHH HH HHO
O O O O O OHO
OH H    H HHO
O OHOHOHOHO O
O2  H HHHH 2O
OOOOOOOOOOOOO

