OOOOOOOOOOOOO
O    HH    2O
O OHOHO O O O
OH HHH  HH  O
OHO OHO OHO O
O H HHH  HH O
O OHO O O OHO
OHHHHHH HHHHO
OHO OHOHOHOHO
OHH H1HH  HHO
O OHOHOHOHO O
O  HH  HHH 3O
OOOOOOOOOOOOO

