OOOOOOOOOOOOO
O   HHH HH 2O
O1OHOHOHO O O
O HH  HHH H O
OHOHOHOHOHO O
O   HHH   HHO
OHOHOHOHOHO O
O HH  HH  HHO
OHO OHOHO OHO
OHHHHH   HH O
O O O OHOHO O
O3   HH    4O
OOOOOOOOOOOOO

