OOOOOOOOOOOOO
O  1HHHHH  2O
O O OHO OHO O
O HHHHHHHHHHO
OHOHO OHOHOHO
O HHH H HHH O
OHO OHO O OHO
O HH HH   H O
OHO O O O OHO
OH HH  HH HHO
O OHOHO O O O
O  H HHHHH  O
OOOOOOOOOOOOO

